Partial Array Size, Num Rows, Num Uncov Int, Num edges, Max Deg, Min Deg, Num Extra Rows
5800,6488,9625,35184719,7880,6820,688
5805,6509,9751,36168788,7944,6862,704
5810,6506,9605,35080335,7773,6769,696
5815,6508,9497,34228416,7712,6649,693
5820,6485,9210,32206573,7464,6405,665
5825,6516,9355,33229752,7579,6573,691
5830,6510,9318,32960085,7589,6556,680
5835,6519,9130,31723849,7402,6443,684
5840,6511,9294,32799391,7549,6477,671
5845,6515,9248,32510799,7438,6510,670
5850,6538,8937,30392990,7248,6361,688
5855,6540,8930,30341429,7264,6355,685
5860,6534,8731,29060424,7063,6258,674
5865,6515,8428,27012664,6839,6020,650
5870,6539,8878,29935608,7303,6190,669
5875,6523,8761,29128021,7165,6190,648
5880,6544,8687,28697432,7025,6140,664
5885,6549,8459,27245089,6798,6043,664
5890,6537,8437,27113436,6800,6027,647
5895,6555,8577,28016461,6924,6157,660
5900,6543,8281,26092934,6730,5905,643
5905,6529,7833,23358084,6348,5613,624
5910,6555,8124,25099905,6628,5766,645
5915,6580,8224,25697227,6648,5825,665
5920,6562,8049,24651089,6516,5757,642
5925,6564,8145,25222205,6599,5703,639
5930,6567,8036,24529075,6555,5655,637
5935,6572,8131,25150367,6596,5792,637
5940,6580,7931,23909152,6463,5530,640
5945,6591,7997,24347243,6471,5722,646
5950,6563,7781,23001232,6425,5492,613
5955,6580,7747,22849600,6281,5480,625
5960,6608,7828,23260186,6381,5459,648
5965,6586,7489,21317162,6080,5251,621
5970,6589,7649,22227344,6255,5435,619
5975,6585,7476,21241463,6106,5287,610
5980,6594,7643,22184934,6222,5363,614
5985,6584,7393,20745039,6047,5197,599
5990,6595,7171,19529349,5820,5021,605
5995,6589,7325,20373554,5953,5136,594
6000,6611,7415,20893469,6013,5206,611
6005,6606,7426,20923972,6043,5187,601
6010,6610,7123,19299716,5764,4994,600
6015,6612,7253,19956184,5892,5028,597
6020,6592,7009,18673169,5717,4941,572
6025,6626,7101,19145857,5742,4942,601
6030,6629,7155,19433066,5783,4978,599
6035,6624,6987,18526448,5722,4827,589
6040,6629,6910,18163840,5591,4907,589
6045,6636,6935,18298668,5633,4876,591
6050,6637,6860,17875511,5565,4757,587
6055,6626,6755,17347942,5486,4769,571
6060,6648,6880,18004970,5581,4892,588
6065,6630,6466,15909817,5218,4638,565
6070,6639,6537,16211447,5357,4534,569
6075,6630,6592,16504541,5365,4582,555
6080,6645,6410,15632058,5230,4551,565
6085,6669,6302,15118419,5098,4456,584
6090,6651,6445,15774168,5223,4457,561
6095,6654,6397,15539769,5290,4487,559
6100,6656,6504,16052968,5280,4578,556
6105,6671,6412,15630805,5206,4531,566
6110,6667,6392,15498125,5202,4446,557
6115,6662,6159,14389245,4992,4285,547
6120,6676,6252,14822711,5134,4445,556
6125,6683,6243,14782302,5120,4379,558
6130,6680,6259,14892721,5082,4443,550
6135,6699,6008,13718094,4889,4190,564
6140,6672,6143,14343906,4986,4311,532
6145,6682,6025,13744126,4984,4171,537
6150,6683,5990,13606335,4935,4197,533
6155,6698,5872,13102928,4781,4160,543
6160,6677,5603,11928775,4564,3960,517
6165,6698,5891,13197056,4788,4168,533
6170,6717,5865,13080079,4776,4115,547
6175,6699,5625,12026969,4553,3975,524
6180,6699,5595,11903071,4526,3922,519
6185,6716,5656,12166969,4643,4005,531
6190,6693,5435,11227416,4403,3836,503
6195,6716,5662,12204362,4550,4012,521
6200,6729,5490,11463182,4453,3903,529
6205,6696,5061,9753304,4083,3541,491
6210,6705,5188,10257259,4185,3709,495
6215,6737,5532,11635172,4470,3947,522
6220,6731,5335,10804940,4371,3759,511
6225,6733,5447,11282792,4373,3885,508
6230,6735,5295,10646960,4325,3767,505
6235,6740,5398,11074185,4398,3822,505
6240,6747,5234,10405514,4253,3685,507
6245,6732,5095,9872451,4129,3602,487
6250,6755,5265,10516114,4276,3631,505
6255,6757,5217,10322864,4232,3607,502
6260,6758,5173,10153281,4211,3644,498
6265,6748,4750,8582362,3881,3403,483
6270,6751,5042,9660932,4088,3584,481
6275,6747,4978,9404153,4058,3504,472
6280,6748,4644,8197430,3780,3216,468
6285,6765,4827,8851500,3994,3380,480
6290,6776,4839,8896553,3927,3427,486
6295,6772,4664,8265637,3803,3293,477
6300,6768,4626,8133207,3777,3298,468
6305,6775,4795,8739521,3886,3388,470
6310,6799,4853,8944804,3937,3425,489
6315,6801,4832,8862145,3955,3365,486
6320,6791,4667,8279124,3794,3276,471
6325,6790,4650,8230229,3781,3298,465
6330,6832,4692,8375409,3815,3336,502
6335,6803,4682,8329958,3810,3298,468
6340,6798,4448,7509511,3646,3085,458
6345,6812,4589,7980095,3763,3173,467
6350,6802,4363,7245941,3513,3128,452
6355,6826,4414,7399293,3597,3117,471
6360,6828,4549,7854317,3705,3186,468
6365,6824,4347,7173136,3557,3060,459
6370,6824,4491,7663315,3641,3156,454
6375,6828,4441,7492654,3631,3139,453
6380,6830,4277,6952033,3502,3025,450
6385,6826,4395,7335899,3547,3067,441
6390,6849,4243,6844521,3442,2978,459
6395,6836,4235,6807209,3447,2992,441
6400,6847,4215,6751242,3422,2946,447
6405,6851,4294,7011366,3465,3079,446
6410,6859,4114,6433681,3346,2946,449
6415,6862,4139,6498832,3360,2925,447
6420,6850,4160,6566843,3422,2918,430
6425,6863,4108,6426030,3321,2933,438
6430,6863,3980,6027989,3214,2836,433
6435,6861,3939,5903388,3255,2766,426
6440,6863,3882,5725418,3148,2722,423
6445,6869,3837,5596254,3098,2706,424
6450,6866,3717,5253943,3004,2641,416
6455,6873,3924,5850117,3189,2785,418
6460,6879,3844,5610082,3149,2709,419
6465,6881,3909,5793603,3187,2684,416
6470,6881,3899,5760501,3179,2713,411
6475,6880,3721,5251295,3027,2635,405
6480,6899,3857,5634747,3147,2622,419
6485,6908,3779,5416586,3074,2604,423
6490,6916,3734,5302002,3026,2610,426
6495,6897,3758,5350330,3086,2627,402
6500,6902,3688,5148547,3056,2564,402
6505,6916,3724,5260404,3060,2609,411
6510,6919,3648,5058181,3002,2558,409
6515,6918,3625,4995352,2980,2602,403
6520,6911,3529,4715932,2886,2400,391
6525,6932,3638,5020980,2966,2526,407
6530,6921,3412,4417532,2786,2374,391
6535,6938,3367,4308659,2718,2373,403
6540,6944,3560,4803416,2963,2501,404
6545,6936,3531,4724806,2905,2390,391
6550,6943,3387,4351434,2745,2394,393
6555,6928,3235,3981776,2645,2309,373
6560,6950,3399,4388160,2786,2380,390
6565,6940,3134,3732130,2569,2210,375
6570,6955,3359,4288059,2737,2371,385
6575,6958,3378,4334544,2766,2388,383
6580,6965,3258,4030566,2652,2268,385
6585,6947,3135,3729581,2574,2208,362
6590,6958,3155,3766651,2589,2179,368
6595,6967,3295,4117806,2695,2262,372
6600,6990,3222,3951124,2625,2268,390
6605,6967,3086,3609041,2573,2154,362
6610,6979,3149,3767148,2576,2214,369
6615,6996,3174,3820664,2594,2186,381
6620,6982,3101,3648959,2554,2159,362
6625,7006,3125,3710231,2529,2197,381
6630,6991,2932,3264163,2413,2074,361
6635,6992,3079,3601733,2531,2157,357
6640,6989,2833,3048961,2304,1970,349
6645,6993,2997,3408277,2454,2114,348
6650,7008,2914,3225650,2385,2052,358
6655,7012,2818,3017560,2311,1973,357
6660,7022,2985,3378721,2433,2068,362
6665,7018,2948,3301271,2420,2068,353
6670,7032,2953,3322024,2390,2112,362
6675,7018,2895,3184518,2370,2069,343
6680,7022,2862,3116797,2307,2052,342
6685,7045,2882,3155560,2357,2020,360
6690,7048,2873,3133745,2333,2016,358
6695,7031,2799,2975916,2275,1980,336
6700,7041,2727,2826321,2234,1905,341
6705,7043,2805,2985011,2276,1975,338
6710,7039,2611,2591319,2140,1833,329
6715,7050,2674,2719187,2165,1905,335
6720,7054,2623,2618705,2166,1864,334
6725,7047,2529,2431751,2070,1799,322
6730,7060,2700,2763974,2204,1906,330
6735,7068,2589,2547350,2100,1834,333
6740,7070,2664,2695878,2181,1857,330
6745,7073,2585,2533877,2109,1827,328
6750,7087,2578,2524110,2094,1809,337
6755,7065,2296,2003457,1861,1602,310
6760,7095,2514,2397179,2051,1742,335
6765,7102,2568,2503322,2086,1812,337
6770,7101,2527,2432339,2064,1806,331
6775,7087,2520,2406157,2072,1734,312
6780,7086,2353,2099257,1923,1641,306
6785,7094,2402,2189828,1963,1665,309
6790,7098,2487,2348403,2014,1742,308
6795,7112,2472,2309647,2024,1708,317
6800,7103,2374,2140815,1928,1683,303
6805,7116,2383,2156779,1934,1671,311
6810,7112,2354,2107561,1917,1670,302
6815,7128,2445,2262546,1992,1705,313
6820,7126,2418,2213885,1988,1684,306
6825,7132,2354,2101405,1915,1630,307
6830,7140,2370,2131562,1923,1689,310
6835,7131,2281,1974612,1861,1586,296
6840,7148,2323,2047360,1895,1626,308
6845,7141,2304,2009992,1887,1606,296
6850,7153,2232,1888045,1820,1575,303
6855,7162,2302,2010738,1890,1613,307
6860,7156,2117,1701819,1732,1493,296
6865,7162,2249,1912911,1848,1558,297
6870,7163,2248,1912212,1828,1573,293
6875,7155,2125,1714888,1737,1478,280
6880,7171,2193,1822719,1795,1542,291
6885,7171,2094,1657813,1721,1449,286
6890,7183,2134,1729991,1729,1515,293
6895,7181,2076,1638282,1682,1465,286
6900,7189,2066,1620437,1673,1445,289
6905,7190,2066,1620731,1697,1433,285
6910,7195,2076,1632674,1715,1423,285
6915,7186,1881,1343920,1543,1307,271
6920,7209,2035,1575611,1672,1424,289
6925,7205,2067,1617590,1709,1426,280
6930,7203,1894,1361359,1553,1343,273
6935,7211,1930,1416222,1582,1377,276
6940,7216,2005,1522777,1641,1374,276
6945,7214,1908,1381218,1563,1326,269
6950,7222,1858,1312258,1519,1316,272
6955,7233,1991,1506566,1610,1385,278
6960,7228,1923,1401284,1587,1331,268
6965,7240,1961,1460540,1610,1356,275
6970,7248,1958,1455570,1594,1374,278
6975,7256,1958,1456448,1592,1380,281
6980,7246,1847,1294873,1492,1293,266
6985,7252,1874,1331168,1544,1323,267
6990,7264,1884,1349292,1533,1320,274
6995,7267,1868,1328645,1530,1313,272
7000,7266,1869,1324875,1538,1306,266
7005,7270,1813,1242772,1479,1267,265
7010,7274,1808,1238712,1472,1255,264
7015,7275,1742,1154449,1410,1215,260
7020,7272,1791,1214854,1477,1249,252
7025,7282,1736,1144849,1422,1213,257
7030,7290,1815,1249277,1479,1256,260
7035,7289,1779,1198600,1453,1230,254
7040,7283,1664,1049970,1361,1158,243
7045,7308,1754,1168229,1430,1207,263
7050,7306,1753,1163885,1437,1203,256
7055,7292,1614,984912,1319,1114,237
7060,7314,1726,1131490,1414,1197,254
7065,7310,1735,1135344,1426,1196,245
7070,7317,1679,1068731,1362,1161,247
7075,7321,1656,1038587,1372,1147,246
7080,7320,1654,1032383,1356,1126,240
7085,7329,1606,977877,1332,1131,244
7090,7336,1622,998751,1319,1132,246
7095,7337,1666,1050465,1365,1136,242
7100,7324,1509,861564,1234,1034,224
7105,7335,1518,872965,1258,1055,230
7110,7334,1487,836628,1220,1037,224
7115,7353,1544,902268,1283,1043,238
7120,7358,1544,903771,1258,1070,238
7125,7351,1528,881868,1270,1038,226
7130,7366,1562,923341,1295,1072,236
7135,7364,1492,842814,1243,1012,229
7140,7374,1522,874053,1260,1015,234
7145,7369,1454,797806,1202,970,224
7150,7378,1527,884307,1249,1057,228
7155,7377,1514,865246,1234,1041,222
7160,7386,1444,790289,1188,999,226
7165,7377,1338,678978,1090,919,212
7170,7395,1411,752235,1167,972,225
7175,7394,1476,825133,1204,999,219
7180,7398,1436,781641,1171,990,218
7185,7412,1467,813786,1198,1012,227
7190,7418,1460,807676,1200,993,228
7195,7416,1364,705706,1126,953,221
7200,7418,1434,780516,1181,1013,218
7205,7426,1372,714031,1115,955,221
7210,7429,1383,721395,1156,932,219
7215,7435,1400,742219,1157,980,220
7220,7424,1326,663433,1100,893,204
7225,7435,1360,700316,1113,924,210
7230,7436,1274,614949,1041,894,206
7235,7444,1316,658420,1085,930,209
7240,7454,1362,702658,1111,940,214
7245,7437,1164,512931,958,785,192
7250,7446,1251,592276,1050,862,196
7255,7468,1323,663293,1109,918,213
7260,7473,1295,635659,1060,885,213
7265,7472,1296,636376,1057,901,207
7270,7465,1203,548651,982,818,195
7275,7486,1281,621790,1045,881,211
7280,7476,1219,564867,1003,850,196
7285,7482,1235,577537,1012,867,197
7290,7491,1183,530921,957,828,201
7295,7488,1229,571808,1017,858,193
7300,7496,1236,577782,1023,845,196
7305,7499,1163,512871,951,817,194
7310,7501,1190,536718,973,798,191
7315,7501,1152,501371,944,778,186
7320,7523,1194,540542,976,828,203
7325,7525,1185,530739,968,796,200
7330,7507,1074,438332,881,750,177
7335,7531,1196,542067,968,836,196
7340,7536,1175,521122,982,804,196
7345,7537,1153,504010,940,800,192
7350,7535,1105,463444,914,749,185
7355,7540,1111,467928,915,779,185
7360,7553,1140,493371,932,801,193
7365,7556,1138,490786,933,781,191
7370,7555,1120,476104,913,778,185
7375,7550,1052,418683,868,718,175
7380,7554,1021,393334,836,693,174
7385,7572,1095,455086,897,768,187
7390,7569,1078,439510,883,741,179
7395,7572,1047,415966,858,727,177
7400,7584,1071,434991,901,747,184
7405,7581,1029,401926,841,708,176
7410,7589,1056,422539,876,726,179
7415,7589,1018,393696,828,705,174
7420,7603,1052,419786,852,736,183
7425,7600,988,370273,804,688,175
7430,7610,1048,414681,863,724,180
7435,7611,989,370911,812,684,176
7440,7607,974,359927,809,668,167
7445,7619,987,369822,800,673,174
7450,7618,1015,390077,833,693,168
7455,7621,969,356492,802,681,166
7460,7622,957,346307,786,655,162
7465,7638,987,369319,810,687,173
7470,7631,926,325279,766,645,161
7475,7644,907,312761,740,638,169
7480,7637,857,277915,700,593,157
7485,7640,889,299923,729,609,155
7490,7653,958,345485,798,632,163
7495,7659,948,340627,786,656,164
7500,7662,930,326424,776,639,162
7505,7658,912,314946,746,629,153
7510,7677,914,316118,749,632,167
7515,7672,867,285802,702,607,157
7520,7690,924,324735,760,651,170
7525,7684,890,299847,730,619,159
7530,7694,866,285678,709,597,164
7535,7684,823,256641,679,575,149
7540,7697,872,287667,723,574,157
7545,7694,793,238415,658,549,149
7550,7702,826,257767,681,572,152
7555,7712,855,276680,696,588,157
7560,7710,791,236921,656,549,150
7565,7709,775,226785,648,531,144
7570,7721,863,280429,709,568,151
7575,7729,844,269657,692,575,154
7580,7729,841,266408,699,563,149
7585,7733,833,261177,684,558,148
7590,7740,838,265641,696,581,150
7595,7741,829,259893,684,572,146
7600,7752,817,252613,673,564,152
